. . . / . . .
. . . . b . .
. . # . . . .
. . \ . / . .
. . . . . . .
. . . . # . .
. . . . . . o
2
