. . . / . . .
. . # . . . .
. . . \ . . .
. # . . / . .
. . . . . # .
b . / . . . .
# . . . . . o
3
