b . . . . . |
. . . . . . .
. . # . . / #
. . . | . . .
. . . . . # .
. . . . . . .
. . . . \ . o
6
