# . . _ . . .
. . . . . . #
. . # . b . .
. . . | . . .
. / . . . # .
. . . . . . .
. . . . \ . o
5
