. . . . . . .
. . . . . . .
. . . . . . .
. . \ . . . .
. . . . . . .
. . . b . . .
. . . . . . o
1
