b . . . . . . 
. . . . . . . 
. . . . . . . 
. . \ . \ . . 
. . . . . . . 
. . . . . . . 
. . . . . . o 
