b . . / . . . 
. . . . . . . 
. . # . . . . 
. . \ . / . . 
. . . . . . . 
. . _ . # . . 
\ . . . . . o 
