b . . _ . . \ 
. . . . . . . 
. . # . . / . 
. . . | . . . 
. / . . . # . 
. . . . . . . 
. . . . \ . o 
